F 0,99,23
C 171,154,137

NO textures/image.png
SO textures/image1.png
WE textures/image2.png
EA textures/image3.png

1111111111111111111
1001001001001001001
1001001001001001001
1001001001001001001
1001001000001001001
100000000E000000001
1000011111111000001
1111000000000001111
1000000101010000001
1111111111111111111