NO textures/north.png
SO textures/south.png
WE textures/west.png
EA textures/east.png

F 220,100,0
C 225,30,0

11111
100011111111
10N000000001
101011111111
11111