NO textures/imag.png
SO textures/image1.png
WE textures/image2.png
EA textures/image3.png

F 220,100,2
C 225,30,0


1111111111
1E00000001
1111111111
