NO textures/north.png
SO textures/south.png
WE textures/west.png
EA textures/east.png

F 0,0,0
C 0,0,0

1111111111111
1N00000000001
1111111111111
