NO textures/north.png
SO textures/south.png
WE textures/west.png
EA textures/east.png

F 152,2, 2
C 222,30,0

11111
10001
10E01
10001
11111